Date Type,Date,Location,Total Doses Administered Daily,Dose,Total Doses Administered Cumulative,People Receiving 1 or More Doses Cumulative,7-Day Avg Daily Count Dose 1,7-Day Avg Total Doses Daily,Total Doses Administered Daily Change,7-Day Avg Total Doses Administered Daily Change,Daily Count of People Fully Vaccinated,People Fully Vaccinated Cumulative,7-Day Avg Daily Count of People Fully Vaccinated,Daily Count People Receiving a Booster Dose,People Receiving a Booster Dose Cumulative,7-Day Average Daily Count Booster
Admin,2020-12-14,US,4552,4393,33488,28545,14273,16744,N/A,N/A,118,5645,2822,0,0,0
Admin,2020-12-15,US,49670,47343,83158,75888,25296,27719,N/A,N/A,259,5904,1968,0,0,0
Admin,2020-12-16,US,159730,154347,242888,230235,57559,60722,N/A,N/A,465,6369,1592,0,0,0
Admin,2020-12-17,US,272365,265257,515253,495492,99098,103050,N/A,N/A,738,7107,1421,0,0,0
Admin,2020-12-18,US,416044,407512,931297,903004,150501,155216,N/A,N/A,1195,8302,1383,0,0,0
Admin,2020-12-19,US,181759,177840,1113056,1080844,154406,159008,N/A,N/A,1044,9346,1335,0,0,0
Admin,2020-12-20,US,105154,103225,1218210,1184069,165702,169896,N/A,N/A,697,10043,645,0,0,0
Admin,2020-12-21,US,381572,375054,1599782,1559123,218654,223756,N/A,N/A,1475,11518,839,0,0,0
Admin,2020-12-22,US,447328,438853,2047110,1997976,274584,280564,N/A,N/A,2854,14372,1209,0,0,0
Admin,2020-12-23,US,574664,562236,2621774,2560212,332854,339840,N/A,N/A,2902,17274,1557,0,0,0
Admin,2020-12-24,US,195803,190802,2817577,2751014,322217,328903,N/A,N/A,1087,18361,1607,0,0,0
Admin,2020-12-25,US,12642,12490,2830219,2763504,265786,271274,N/A,N/A,101,18462,1451,0,0,0
Admin,2020-12-26,US,141841,137904,2972060,2901408,260081,265572,N/A,N/A,963,19425,1439,0,0,0
Admin,2020-12-27,US,96641,93368,3068701,2994776,258672,264355,N/A,N/A,716,20141,1442,0,0,0
Admin,2020-12-28,US,590493,576182,3659194,3570958,287405,294201,N/A,N/A,4085,24226,1815,0,0,0
Admin,2020-12-29,US,721432,702448,4380626,4273406,325061,333359,N/A,N/A,5203,29429,2151,0,0,0
Admin,2020-12-30,US,842619,822861,5223245,5096267,362294,371638,N/A,N/A,7705,37134,2837,0,0,0
Admin,2020-12-31,US,419883,410031,5643128,5506298,393612,403650,N/A,N/A,3107,40241,3125,0,0,0
Admin,2021-01-01,US,100395,91109,5743523,5597407,404843,416186,N/A,N/A,6615,46856,4056,0,0,0
Admin,2021-01-02,US,264172,255339,6007695,5852746,421620,433662,N/A,N/A,2821,49677,4321,0,0,0
Admin,2021-01-03,US,138728,131740,6146423,5984486,427101,439674,N/A,N/A,2432,52109,4566,0,0,0
Admin,2021-01-04,US,656729,597585,6803152,6582071,430159,449136,N/A,N/A,45654,97763,10505,0,0,0
Admin,2021-01-05,US,830763,728992,7633915,7311063,433951,464755,N/A,N/A,88223,185986,22365,0,0,0
Admin,2021-01-06,US,1020520,830267,8654435,8141330,435009,490170,N/A,N/A,171953,357939,45829,0,0,0
Admin,2021-01-07,US,1169313,865901,9823748,9007231,500133,597231,N/A,N/A,280282,638221,85425,0,0,0
Admin,2021-01-08,US,1235603,846984,11059351,9854215,608115,759404,N/A,N/A,362692,1000913,136293,0,0,0
Admin,2021-01-09,US,508632,370251,11567983,10224466,624531,794326,N/A,N/A,128318,1129231,154222,0,0,0
Admin,2021-01-10,US,250917,176240,11818900,10400706,630889,810353,N/A,N/A,69407,1198638,163789,0,0,0
Admin,2021-01-11,US,1069855,723182,12888755,11123888,648831,869371,N/A,N/A,322089,1520727,203280,0,0,0
Admin,2021-01-12,US,1257463,916193,14146218,12040081,675574,930329,N/A,N/A,313966,1834693,235529,0,0,0
Admin,2021-01-13,US,1322781,1028913,15468999,13068994,703952,973509,N/A,N/A,270021,2104714,249539,0,0,0
Admin,2021-01-14,US,1315451,1156129,16784450,14225123,745413,994386,N/A,N/A,135498,2240212,228855,0,0,0
Admin,2021-01-15,US,1255811,1115852,18040261,15340975,783823,997272,N/A,N/A,120311,2360523,194230,0,0,0
Admin,2021-01-16,US,648743,565753,18689004,15906728,811752,1017288,N/A,N/A,71791,2432314,186154,0,0,0
Admin,2021-01-17,US,304744,255411,18993748,16162139,823062,1024978,N/A,N/A,41995,2474309,182238,0,0,0
Admin,2021-01-18,US,883951,637925,19877699,16800064,810882,998420,N/A,N/A,226221,2700530,168543,0,0,0
Admin,2021-01-19,US,1345415,964706,21223114,17764770,817813,1010985,N/A,N/A,354061,3054591,174271,0,0,0
Admin,2021-01-20,US,1601189,1153007,22824303,18917777,835540,1050757,N/A,N/A,418221,3472812,195442,0,0,0
Admin,2021-01-21,US,1629417,1328864,24453720,20246641,860217,1095610,N/A,N/A,273146,3745958,215106,0,0,0
Admin,2021-01-22,US,1626347,1391681,26080067,21638322,899621,1148543,N/A,N/A,208525,3954483,227708,0,0,0
Admin,2021-01-23,US,906306,742257,26986373,22380579,924836,1185338,N/A,N/A,149507,4103990,238810,0,0,0
Admin,2021-01-24,US,394712,299433,27381085,22680012,931125,1198191,N/A,N/A,87474,4191464,245307,0,0,0
Admin,2021-01-25,US,1371870,859175,28752955,23539187,962732,1267893,N/A,N/A,485686,4677150,282374,0,0,0
Admin,2021-01-26,US,1660156,1051682,30413111,24590869,975157,1312856,N/A,N/A,577724,5254874,314326,0,0,0
Admin,2021-01-27,US,1929734,1248922,32342845,25839791,988859,1359791,N/A,N/A,643344,5898218,346486,0,0,0
Admin,2021-01-28,US,1959741,1368345,34302586,27208136,994499,1406980,N/A,N/A,552881,6451099,386448,0,0,0
Admin,2021-01-29,US,1912311,1371001,36214897,28579137,991545,1447832,N/A,N/A,491848,6942947,426923,0,0,0
Admin,2021-01-30,US,1017242,757565,37232139,29336702,993732,1463680,N/A,N/A,241242,7184189,440028,0,0,0
Admin,2021-01-31,US,458407,321069,37690546,29657771,996823,1472780,N/A,N/A,125984,7310173,445529,0,0,0
Admin,2021-02-01,US,1380597,767534,39071143,30425305,983731,1474026,N/A,N/A,568444,7878617,457352,0,0,0
Admin,2021-02-02,US,1694157,961268,40765300,31386573,970815,1478884,N/A,N/A,694214,8572831,473993,0,0,0
Admin,2021-02-03,US,2136151,1258249,42901451,32644822,972147,1508372,N/A,N/A,828848,9401679,500494,0,0,0
Admin,2021-02-04,US,2343590,1386902,45245041,34031724,974798,1563207,N/A,N/A,907851,10309530,551204,0,0,0
Admin,2021-02-05,US,2352841,1353255,47597882,35384979,972263,1626140,N/A,N/A,954400,11263930,617283,0,0,0
Admin,2021-02-06,US,1298783,850582,48896665,36235561,985551,1666360,N/A,N/A,419659,11683589,642771,0,0,0
Admin,2021-02-07,US,443582,276436,49340247,36511997,979175,1664243,N/A,N/A,155771,11839360,647026,0,0,0
Admin,2021-02-08,US,1576916,835730,50917163,37347727,988917,1692288,N/A,N/A,701550,12540910,666041,0,0,0
Admin,2021-02-09,US,1971926,1035986,52889089,38383713,999591,1731969,N/A,N/A,889058,13429968,693876,0,0,0
Admin,2021-02-10,US,2301601,1227259,55190690,39610972,995164,1755605,N/A,N/A,1029451,14459419,722534,0,0,0
Admin,2021-02-11,US,2403917,1275105,57594607,40886077,979193,1764223,N/A,N/A,1084009,15543428,747699,0,0,0
Admin,2021-02-12,US,2582296,1377154,60176903,42263231,982607,1797003,N/A,N/A,1153499,16696927,776142,0,0,0
Admin,2021-02-13,US,1471804,867873,61648707,43131104,985078,1821720,N/A,N/A,569220,17266147,797508,0,0,0
Admin,2021-02-14,US,591429,345879,62240136,43476983,994998,1842841,N/A,N/A,228271,17494418,807865,0,0,0
Admin,2021-02-15,US,1176570,609187,63416706,44086170,962635,1785649,N/A,N/A,533644,18028062,783878,0,0,0
Admin,2021-02-16,US,1619964,796068,65036670,44882238,928361,1735368,N/A,N/A,783653,18811715,768821,0,0,0
Admin,2021-02-17,US,1963297,932590,66999967,45814828,886265,1687039,N/A,N/A,986538,19798253,762690,0,0,0
Admin,2021-02-18,US,1855300,833071,68855267,46647899,823117,1608665,N/A,N/A,970388,20768641,746459,0,0,0
Admin,2021-02-19,US,1965421,823284,70820688,47471183,743993,1520540,N/A,N/A,1090858,21859499,737510,0,0,0
Admin,2021-02-20,US,1304600,596465,72125288,48067648,705221,1496654,N/A,N/A,677175,22536674,752932,0,0,0
Admin,2021-02-21,US,594569,254168,72719857,48321816,692119,1497103,N/A,N/A,321240,22857914,766213,0,0,0
Admin,2021-02-22,US,1460034,616600,74179891,48938416,693178,1537597,N/A,N/A,798431,23656345,804040,0,0,0
Admin,2021-02-23,US,1934881,865569,76114772,49803985,703107,1582586,N/A,N/A,1020823,24677168,837921,0,0,0
Admin,2021-02-24,US,2524635,1244339,78639407,51048324,747642,1662777,N/A,N/A,1227725,25904893,872377,0,0,0
Admin,2021-02-25,US,2935143,1536105,81574550,52584429,848076,1817040,N/A,N/A,1334220,27239113,924353,0,0,0
Admin,2021-02-26,US,3111160,1671934,84685710,54256363,969311,1980717,N/A,N/A,1374060,28613173,964810,0,0,0
Admin,2021-02-27,US,1993167,1139967,86678877,55396330,1046955,2079084,N/A,N/A,813966,29427139,984352,0,0,0
Admin,2021-02-28,US,854228,534275,87533105,55930605,1086970,2116178,N/A,N/A,293874,29721013,980442,0,0,0
Admin,2021-03-01,US,2044663,1195155,89577768,57125760,1169621,2199696,N/A,N/A,789786,30510799,979207,0,0,0
Admin,2021-03-02,US,2460980,1462192,92038748,58587952,1254852,2274853,N/A,N/A,954905,31465704,969790,0,0,0
Admin,2021-03-03,US,2899862,1740590,94938610,60328542,1325745,2328457,N/A,N/A,1117382,32583086,954027,0,0,0
Admin,2021-03-04,US,3200763,1955264,98139373,62283806,1385625,2366403,N/A,N/A,1238020,33821106,940284,0,0,0
Admin,2021-03-05,US,3226134,2002583,101365507,64286389,1432861,2382828,N/A,N/A,1299095,35120201,929575,0,0,0
Admin,2021-03-06,US,2056951,1349584,103422458,65635973,1462806,2391940,N/A,N/A,860332,35980533,936199,0,0,0
Admin,2021-03-07,US,923661,676982,104346119,66312955,1483193,2401859,N/A,N/A,342006,36322539,943075,0,0,0
Admin,2021-03-08,US,2162237,1481302,106508356,67794257,1524071,2418655,N/A,N/A,848097,37170636,951405,0,0,0
Admin,2021-03-09,US,2704572,1807712,109212928,69601969,1573431,2453454,N/A,N/A,1076578,38247214,968787,0,0,0
Admin,2021-03-10,US,3121736,2061388,112334664,71663357,1619259,2485150,N/A,N/A,1263849,39511063,989711,0,0,0
Admin,2021-03-11,US,3436924,2275880,115771588,73939237,1665062,2518887,N/A,N/A,1394149,40905212,1012015,0,0,0
Admin,2021-03-12,US,3424660,2116181,119196248,76055418,1681290,2547248,N/A,N/A,1521694,42426906,1043815,0,0,0
Admin,2021-03-13,US,2188414,1384098,121384662,77439516,1686220,2566029,N/A,N/A,1014912,43441818,1065897,0,0,0
Admin,2021-03-14,US,982885,647683,122367547,78087199,1682035,2574489,N/A,N/A,425492,43867310,1077824,0,0,0
Admin,2021-03-15,US,2279506,1496582,124647053,79583781,1684218,2591242,N/A,N/A,865583,44732893,1080322,0,0,0
Admin,2021-03-16,US,2885331,1929075,127532384,81512856,1701555,2617065,N/A,N/A,1044671,45777564,1075764,0,0,0
Admin,2021-03-17,US,3166036,2126654,130698420,83639510,1710879,2623393,N/A,N/A,1125772,46903336,1056039,0,0,0
Admin,2021-03-18,US,3399742,2294164,134098162,85933674,1713491,2618082,N/A,N/A,1198478,48101814,1028086,0,0,0
Admin,2021-03-19,US,3335887,2212900,137434049,88146574,1727308,2605400,N/A,N/A,1217534,49319348,984634,0,0,0
Admin,2021-03-20,US,2153763,1410123,139587812,89556697,1731026,2600450,N/A,N/A,857422,50176770,962136,0,0,0
Admin,2021-03-21,US,1018252,682558,140606064,90239255,1736008,2605502,N/A,N/A,370167,50546937,954232,0,0,0
Admin,2021-03-22,US,2362487,1603318,142968551,91842573,1751256,2617356,N/A,N/A,803533,51350470,945368,0,0,0
Admin,2021-03-23,US,3062921,1981841,146031472,93824414,1758794,2642726,N/A,N/A,1147537,52498007,960063,0,0,0
Admin,2021-03-24,US,3554453,2207172,149585925,96031586,1770297,2698215,N/A,N/A,1417189,53915196,1001694,0,0,0
Admin,2021-03-25,US,3833076,2265564,153419001,98297150,1766211,2760119,N/A,N/A,1641382,55556578,1064966,0,0,0
Admin,2021-03-26,US,3827788,2103760,157246789,100400910,1750619,2830391,N/A,N/A,1793975,57350553,1147315,0,0,0
Admin,2021-03-27,US,2470275,1370127,159717064,101771037,1744906,2875607,N/A,N/A,1160880,58511433,1190666,0,0,0
Admin,2021-03-28,US,1209029,671115,160926093,102442152,1743271,2902861,N/A,N/A,549204,59060637,1216242,0,0,0
Admin,2021-03-29,US,2836059,1607232,163762152,104049384,1743830,2970514,N/A,N/A,1270108,60330745,1282896,0,0,0
Admin,2021-03-30,US,3589916,2011816,167352068,106061200,1748112,3045799,N/A,N/A,1654805,61985550,1355363,0,0,0
Admin,2021-03-31,US,4168271,2410813,171520339,108472013,1777204,3133487,N/A,N/A,1933535,63919085,1429127,0,0,0
Admin,2021-04-01,US,4546854,2525773,176067193,110997786,1814377,3235456,N/A,N/A,2232911,66151996,1513631,0,0,0
Admin,2021-04-02,US,3652708,2056541,179719901,113054327,1807631,3210444,N/A,N/A,1809666,67961662,1515872,0,0,0
Admin,2021-04-03,US,2298434,1322937,182018335,114377264,1800890,3185895,N/A,N/A,1155139,69116801,1515052,0,0,0
Admin,2021-04-04,US,762512,437355,182780847,114814619,1767495,3122107,N/A,N/A,370404,69487205,1489509,0,0,0
Admin,2021-04-05,US,3101935,1733042,185882782,116547661,1785468,3160090,N/A,N/A,1595139,71082344,1535942,0,0,0
Admin,2021-04-06,US,3974754,2287292,189857536,118834953,1824822,3215066,N/A,N/A,2070805,73153149,1595371,0,0,0
Admin,2021-04-07,US,4352512,2559248,194210048,121394201,1846027,3241387,N/A,N/A,2295991,75449140,1647150,0,0,0
Admin,2021-04-08,US,4496393,2565150,198706441,123959351,1851652,3234178,N/A,N/A,2506081,77955221,1686175,0,0,0
Admin,2021-04-09,US,4314697,2438418,203021138,126397769,1906206,3328748,N/A,N/A,2426590,80381811,1774307,0,0,0
Admin,2021-04-10,US,2882582,1722581,205903720,128120350,1963298,3412197,N/A,N/A,1650355,82032166,1845052,0,0,0
Admin,2021-04-11,US,1398240,832262,207301960,128952612,2019713,3503016,N/A,N/A,798450,82830616,1906201,0,0,0
Admin,2021-04-12,US,3012061,1629768,210314021,130582380,2004960,3490177,N/A,N/A,1718151,84548767,1923774,0,0,0
Admin,2021-04-13,US,3470136,1737471,213784157,132319851,1926414,3418088,N/A,N/A,1711400,86260167,1872431,0,0,0
Admin,2021-04-14,US,3683044,1725453,217467201,134045304,1807300,3322450,N/A,N/A,1920302,88180469,1818761,0,0,0
Admin,2021-04-15,US,3734028,1748114,221201229,135793418,1690581,3213541,N/A,N/A,1944970,90125439,1738602,0,0,0
Admin,2021-04-16,US,3590874,1629500,224792103,137422918,1575021,3110137,N/A,N/A,1922860,92048299,1666641,0,0,0
Admin,2021-04-17,US,2354758,1160077,227146861,138582995,1494664,3034734,N/A,N/A,1173768,93222067,1598557,0,0,0
Admin,2021-04-18,US,1129261,536913,228276122,139119908,1452471,2996308,N/A,N/A,581009,93803076,1567494,0,0,0
Admin,2021-04-19,US,2572108,1080699,230848230,140200607,1374032,2933458,N/A,N/A,1460453,95263529,1530680,0,0,0
Admin,2021-04-20,US,3218488,1355028,234066718,141555635,1319398,2897508,N/A,N/A,1829609,97093138,1547567,0,0,0
Admin,2021-04-21,US,3459272,1376760,237525990,142932395,1269584,2865541,N/A,N/A,2044246,99137384,1565273,0,0,0
Admin,2021-04-22,US,3480699,1394099,241006689,144326494,1219011,2829351,N/A,N/A,2050350,101187734,1580327,0,0,0
Admin,2021-04-23,US,3280670,1348006,244287359,145674500,1178797,2785036,N/A,N/A,1898064,103085798,1576785,0,0,0
Admin,2021-04-24,US,2199798,1000913,246487157,146675413,1156060,2762899,N/A,N/A,1182848,104268646,1578082,0,0,0
Admin,2021-04-25,US,990117,489244,247477274,147164657,1149250,2743021,N/A,N/A,494374,104763020,1565706,0,0,0
Admin,2021-04-26,US,2378615,930034,249855889,148094691,1127726,2715379,N/A,N/A,1428585,106191605,1561153,0,0,0
Admin,2021-04-27,US,2875023,1101105,252730912,149195796,1091452,2666313,N/A,N/A,1785118,107976723,1554797,0,0,0
Admin,2021-04-28,US,3068536,1139740,255799448,150335536,1057592,2610494,N/A,N/A,1961275,109937998,1542944,0,0,0
Admin,2021-04-29,US,3034794,1106683,258834242,151442219,1016532,2546793,N/A,N/A,1973868,111911866,1532018,0,0,0
Admin,2021-04-30,US,2896638,1103592,261730880,152545811,981616,2491931,N/A,N/A,1842988,113754854,1524150,0,0,0
Admin,2021-05-01,US,1836831,702702,263567711,153248513,939014,2440079,N/A,N/A,1160769,114915623,1520996,0,0,0
Admin,2021-05-02,US,876206,324244,264443917,153572757,915443,2423806,N/A,N/A,583501,115499124,1533729,0,0,0
Admin,2021-05-03,US,1957011,634891,266400928,154207648,873280,2363577,N/A,N/A,1396109,116895233,1529089,0,0,0
Admin,2021-05-04,US,2496579,812449,268897507,155020097,832043,2309513,N/A,N/A,1751333,118646566,1524263,0,0,0
Admin,2021-05-05,US,2540025,811450,271437532,155831547,785144,2234012,N/A,N/A,1800215,120446781,1501254,0,0,0
Admin,2021-05-06,US,2511979,772348,273949511,156603895,737382,2159324,N/A,N/A,1809932,122256713,1477835,0,0,0
Admin,2021-05-07,US,2499098,787624,276448609,157391519,692244,2102532,N/A,N/A,1779480,124036193,1468762,0,0,0
Admin,2021-05-08,US,1530345,504580,277978954,157896099,663941,2058749,N/A,N/A,1083832,125120025,1457771,0,0,0
Admin,2021-05-09,US,613358,204229,278592312,158100328,646796,2021199,N/A,N/A,436079,125556104,1436711,0,0,0
Admin,2021-05-10,US,1599480,480486,280191792,158580814,624738,1970123,N/A,N/A,1169394,126725498,1404323,0,0,0
Admin,2021-05-11,US,2041413,654362,282233205,159235176,602154,1905099,N/A,N/A,1445257,128170755,1360598,0,0,0
Admin,2021-05-12,US,2009855,641752,284243060,159876928,577912,1829361,N/A,N/A,1431467,129602222,1307920,0,0,0
Admin,2021-05-13,US,2270402,924156,286513462,160801084,599598,1794850,N/A,N/A,1400951,131003173,1249494,0,0,0
Admin,2021-05-14,US,2445423,1087935,288958885,161889019,642500,1787182,N/A,N/A,1427949,132431122,1199275,0,0,0
Admin,2021-05-15,US,1841800,904795,290800685,162793814,699674,1831675,N/A,N/A,986923,133418045,1185431,0,0,0
Admin,2021-05-16,US,930915,476349,291731600,163270163,738548,1877041,N/A,N/A,484850,133902895,1192398,0,0,0
Admin,2021-05-17,US,1816932,883558,293548532,164153721,796130,1908105,N/A,N/A,1006599,134909494,1169142,0,0,0
Admin,2021-05-18,US,2067128,987061,295615660,165140782,843658,1911779,N/A,N/A,1158250,136067744,1128141,0,0,0
Admin,2021-05-19,US,2081723,983171,297697383,166123953,892432,1922046,N/A,N/A,1174216,137241960,1091391,0,0,0
Admin,2021-05-20,US,2014343,919524,299711726,167043477,891770,1885466,N/A,N/A,1169960,138411920,1058392,0,0,0
Admin,2021-05-21,US,2052817,929883,301764543,167973360,869192,1829379,N/A,N/A,1194513,139606433,1025044,0,0,0
Admin,2021-05-22,US,1445414,728090,303209957,168701450,843948,1772753,N/A,N/A,767950,140374383,993762,0,0,0
Admin,2021-05-23,US,656879,338106,303866836,169039556,824199,1733605,N/A,N/A,345496,140719879,973854,0,0,0
Admin,2021-05-24,US,1317585,634541,305184421,169674097,788625,1662269,N/A,N/A,746185,141466064,936652,0,0,0
Admin,2021-05-25,US,1433842,666501,306618263,170340598,742831,1571800,N/A,N/A,833518,142299582,890262,0,0,0
Admin,2021-05-26,US,1430594,659084,308048857,170999682,696533,1478782,N/A,N/A,831538,143131120,841308,0,0,0
Admin,2021-05-27,US,1343718,612299,309392575,171611981,652643,1382978,N/A,N/A,791885,143923005,787297,0,0,0
Admin,2021-05-28,US,1325716,602314,310718291,172214295,605848,1279106,N/A,N/A,782070,144705075,728377,0,0,0
Admin,2021-05-29,US,763855,379556,311482146,172593851,556057,1181741,N/A,N/A,419245,145124320,678562,0,0,0
Admin,2021-05-30,US,384092,200720,311866238,172794571,536431,1142771,N/A,N/A,203992,145328312,658347,0,0,0
Admin,2021-05-31,US,201446,88963,312067684,172883534,458491,983323,N/A,N/A,121347,145449659,569085,0,0,0
Admin,2021-06-01,US,1261787,524778,313329471,173408312,438245,958744,N/A,N/A,778624,146228283,561243,0,0,0
Admin,2021-06-02,US,1114375,493707,314443846,173902019,414620,913569,N/A,N/A,675754,146904037,538988,0,0,0
Admin,2021-06-03,US,1243403,462329,315687249,174364348,393195,899239,N/A,N/A,831528,147735565,544651,0,0,0
Admin,2021-06-04,US,1399059,499119,317086308,174863467,378453,909716,N/A,N/A,951545,148687110,568862,0,0,0
Admin,2021-06-05,US,1068450,352652,318154758,175216119,374610,953230,N/A,N/A,747571,149434681,615765,0,0,0
Admin,2021-06-06,US,515334,171145,318670092,175387264,370385,971979,N/A,N/A,361614,149796295,638283,0,0,0
Admin,2021-06-07,US,1067797,372331,319737889,175759595,410866,1095743,N/A,N/A,735623,150531918,726037,0,0,0
Admin,2021-06-08,US,1171788,403290,320909677,176162885,393510,1082886,N/A,N/A,812883,151344801,730931,0,0,0
Admin,2021-06-09,US,1162355,390769,322072032,176553654,378805,1089740,N/A,N/A,816473,152161274,751033,0,0,0
Admin,2021-06-10,US,1166723,403836,323238755,176957490,370449,1078786,N/A,N/A,808717,152969991,747775,0,0,0
Admin,2021-06-11,US,1227891,427112,324466646,177384602,360162,1054334,N/A,N/A,846717,153816708,732799,0,0,0
Admin,2021-06-12,US,891448,280228,325358094,177664830,349816,1029048,N/A,N/A,637906,154454614,717133,0,0,0
Admin,2021-06-13,US,392202,113337,325750296,177778167,341558,1011457,N/A,N/A,294854,154749468,707596,0,0,0
Admin,2021-06-14,US,910859,331929,326661155,178110096,335786,989038,N/A,N/A,615619,155365087,690452,0,0,0
Admin,2021-06-15,US,975977,360285,327637132,178470381,329642,961065,N/A,N/A,656579,156021666,668123,0,0,0
Admin,2021-06-16,US,942245,357988,328579377,178828369,324959,929620,N/A,N/A,626979,156648645,641053,0,0,0
Admin,2021-06-17,US,892245,351361,329471622,179179730,317463,890409,N/A,N/A,587062,157235707,609388,0,0,0
Admin,2021-06-18,US,918994,368078,330390616,179547808,309029,846281,N/A,N/A,591820,157827527,572974,0,0,0
Admin,2021-06-19,US,574454,231098,330965070,179778906,302011,800996,N/A,N/A,367636,158195163,534364,0,0,0
Admin,2021-06-20,US,276236,112247,331241306,179891153,301855,784430,N/A,N/A,174966,158370129,517237,0,0,0
Admin,2021-06-21,US,559594,301499,331800900,180192652,297508,734249,N/A,N/A,290908,158661037,470850,0,0,0
Admin,2021-06-22,US,754361,324238,332555261,180516890,292358,702589,N/A,N/A,465754,159126791,443589,0,0,0
Admin,2021-06-23,US,734601,330586,333289862,180847476,288444,672926,N/A,N/A,438332,159565123,416639,0,0,0
Admin,2021-06-24,US,698366,319079,333988228,181166555,283832,645229,N/A,N/A,414045,159979168,391923,0,0,0
Admin,2021-06-25,US,765721,351331,334753949,181517886,281440,623333,N/A,N/A,448758,160427926,371485,0,0,0
Admin,2021-06-26,US,498649,225430,335252598,181743316,280630,612504,N/A,N/A,293273,160721199,360862,0,0,0
Admin,2021-06-27,US,267042,127171,335519640,181870487,282762,611190,N/A,N/A,149562,160870761,357233,0,0,0
Admin,2021-06-28,US,553033,275974,336072673,182146461,279116,610253,N/A,N/A,302965,161173726,358955,0,0,0
Admin,2021-06-29,US,627199,297994,336699872,182444455,275366,592087,N/A,N/A,355329,161529055,343180,0,0,0
Admin,2021-06-30,US,630724,308045,337330596,182752500,272146,577247,N/A,N/A,348935,161877990,330409,0,0,0
Admin,2021-07-01,US,604799,292871,337935395,183045371,268402,563881,N/A,N/A,331896,162209886,318674,0,0,0
Admin,2021-07-02,US,620425,306881,338555820,183352252,262052,543124,N/A,N/A,339408,162549294,303052,0,0,0
Admin,2021-07-03,US,357684,182145,338913504,183534397,255869,522986,N/A,N/A,187809,162737103,287986,0,0,0
Admin,2021-07-04,US,50381,27838,338963885,183562235,241678,492035,N/A,N/A,27159,162764262,270500,0,0,0
Admin,2021-07-05,US,396642,201683,339360527,183763918,231065,469693,N/A,N/A,207560,162971822,256870,0,0,0
Admin,2021-07-06,US,583998,274689,339944525,184038607,227736,463521,N/A,N/A,333867,163305689,253804,0,0,0
Admin,2021-07-07,US,570362,283013,340514887,184321620,224160,454898,N/A,N/A,314477,163620166,248882,0,0,0
Admin,2021-07-08,US,566122,289447,341081009,184611067,223671,449373,N/A,N/A,305841,163926007,245160,0,0,0
Admin,2021-07-09,US,632375,322596,341713384,184933663,225916,451080,N/A,N/A,339983,164265990,245242,0,0,0
Admin,2021-07-10,US,401231,211631,342114615,185145294,230128,457301,N/A,N/A,205656,164471646,247791,0,0,0
Admin,2021-07-11,US,216788,116937,342331403,185262231,242857,481074,N/A,N/A,107372,164579018,259250,0,0,0
Admin,2021-07-12,US,520018,275411,342851421,185537642,253389,498699,N/A,N/A,268904,164847922,268014,0,0,0
Admin,2021-07-13,US,526812,281705,343378233,185819347,254391,490529,N/A,N/A,266079,165114001,258330,0,0,0
Admin,2021-07-14,US,530985,284298,343909218,186103645,254575,484904,N/A,N/A,267095,165381096,251561,0,0,0
Admin,2021-07-15,US,541167,298705,344450385,186402350,255898,481339,N/A,N/A,262668,165643764,245393,0,0,0
Admin,2021-07-16,US,625221,347871,345075606,186750221,259508,480317,N/A,N/A,297240,165941004,239287,0,0,0
Admin,2021-07-17,US,400238,224161,345475844,186974382,261298,480175,N/A,N/A,187970,166128974,236761,0,0,0
Admin,2021-07-18,US,233920,135635,345709764,187110017,263969,482623,N/A,N/A,104564,166233538,236360,0,0,0
Admin,2021-07-19,US,568205,340213,346277969,187450230,273227,489506,N/A,N/A,247947,166481485,233366,0,0,0
Admin,2021-07-20,US,604193,372576,346882162,187822806,286208,500561,N/A,N/A,253064,166734549,231506,0,0,0
Admin,2021-07-21,US,631396,387910,347513558,188210716,301010,514905,N/A,N/A,264128,166998677,231083,0,0,0
Admin,2021-07-22,US,650013,417370,348163571,188628086,317962,530455,N/A,N/A,254026,167252703,229848,0,0,0
Admin,2021-07-23,US,747899,488595,348911470,189116681,338066,547980,N/A,N/A,282951,167535654,227807,0,0,0
Admin,2021-07-24,US,463508,302233,349374978,189418914,349219,557019,N/A,N/A,172956,167708610,225662,0,0,0
Admin,2021-07-25,US,259385,201893,349634363,189620807,358684,560657,N/A,N/A,62570,167771180,219663,0,0,0
Admin,2021-07-26,US,643576,447648,350277939,190068455,374032,571424,N/A,N/A,218165,167989345,215408,0,0,0
Admin,2021-07-27,US,701213,480603,350979152,190549058,389465,585284,N/A,N/A,247155,168236500,214564,0,0,0
Admin,2021-07-28,US,720092,491303,351699244,191040361,404235,597955,N/A,N/A,255345,168491845,213309,0,0,0
Admin,2021-07-29,US,720111,497646,352419355,191538007,415703,607969,N/A,N/A,249093,168740938,212605,0,0,0
Admin,2021-07-30,US,835285,575568,353254640,192113575,428128,620452,N/A,N/A,287854,169028792,213305,0,0,0
Admin,2021-07-31,US,514916,346369,353769556,192459944,434433,627796,N/A,N/A,179087,169207879,214181,0,0,0
Admin,2021-08-01,US,326565,225832,354096121,192685776,437853,637394,N/A,N/A,98339,169306218,219291,0,0,0
Admin,2021-08-02,US,720194,506196,354816315,193191972,446217,648339,N/A,N/A,236108,169542326,221854,0,0,0
Admin,2021-08-03,US,762241,537812,355578556,193729784,454389,657057,N/A,N/A,251534,169793860,222480,0,0,0
Admin,2021-08-04,US,777752,552051,356356308,194281835,463068,665294,N/A,N/A,253555,170047415,222224,0,0,0
Admin,2021-08-05,US,792528,559626,357148836,194841461,471922,675640,N/A,N/A,262802,170310217,224182,0,0,0
Admin,2021-08-06,US,907690,625942,358056526,195467403,479118,685983,N/A,N/A,310029,170620246,227350,0,0,0
Admin,2021-08-07,US,557692,381529,358614218,195848932,484141,692094,N/A,N/A,189068,170809314,228776,0,0,0
Admin,2021-08-08,US,350233,237664,358964451,196086596,485831,695475,N/A,N/A,117208,170926522,231472,0,0,0
Admin,2021-08-09,US,781831,520262,359746282,196606858,487841,704281,N/A,N/A,285581,171212103,238539,0,0,0
Admin,2021-08-10,US,798685,530073,360544967,197136931,486735,709487,N/A,N/A,293166,171505269,244487,0,0,0
Admin,2021-08-11,US,768545,498772,361313512,197635703,479124,708172,N/A,N/A,294559,171799828,250344,0,0,0
Admin,2021-08-12,US,802354,513878,362115866,198149581,472589,709575,N/A,N/A,312078,172111906,257384,0,0,0
Admin,2021-08-13,US,947568,580964,363063434,198730545,466163,715272,N/A,N/A,387879,172499785,268505,13730,13730,1961
Admin,2021-08-14,US,624706,362200,363688140,199092745,463402,724846,N/A,N/A,241661,172741446,276018,36049,49779,7111
Admin,2021-08-15,US,399058,211676,364087198,199304421,459689,731821,N/A,N/A,160946,172902392,282267,32914,82693,11813
Admin,2021-08-16,US,869387,464434,364956585,199768855,451714,744329,N/A,N/A,352895,173255287,291883,79547,162240,23177
Admin,2021-08-17,US,922762,490022,365879347,200258877,445992,762054,N/A,N/A,362199,173617486,301745,98947,261187,37312
Admin,2021-08-18,US,951761,486941,366831108,200745818,444302,788228,N/A,N/A,377230,173994716,313555,115578,376765,53824
Admin,2021-08-19,US,943894,480115,367775002,201225933,439479,808448,N/A,N/A,379588,174374304,323199,113261,490026,70004
Admin,2021-08-20,US,1105981,537965,368880983,201763898,433336,831078,N/A,N/A,476412,174850716,335847,120867,610893,85309
Admin,2021-08-21,US,664982,321471,369545965,202085369,427518,836832,N/A,N/A,295931,175146647,343600,61201,672094,88902
Admin,2021-08-22,US,389217,184244,369935182,202269613,423599,835426,N/A,N/A,178453,175325100,346101,31442,703536,88692
Admin,2021-08-23,US,918991,441901,370854173,202711514,420380,842512,N/A,N/A,403414,175728514,353318,96185,799721,91069
Admin,2021-08-24,US,949071,462190,371803244,203173704,416404,846271,N/A,N/A,413080,176141594,360586,99741,899462,91182
Admin,2021-08-25,US,965536,470004,372768780,203643708,413984,848238,N/A,N/A,420414,176562008,366756,102630,1002092,89332
Admin,2021-08-26,US,989491,477229,373758271,204120937,413572,854752,N/A,N/A,430881,176992889,374083,110109,1112201,88882
Admin,2021-08-27,US,1169997,535438,374928268,204656375,413211,863897,N/A,N/A,537268,177530157,382777,125440,1237641,89535
Admin,2021-08-28,US,711070,319386,375639338,204975761,412913,870481,N/A,N/A,339014,177869171,388932,63753,1301394,89900
Admin,2021-08-29,US,429708,193823,376069046,205169584,414282,876266,N/A,N/A,204564,178073735,392662,35535,1336929,90485
Admin,2021-08-30,US,924386,417656,376993432,205587240,410818,877037,N/A,N/A,429045,178502780,396323,99392,1436321,90943
Admin,2021-08-31,US,925573,419249,377919005,206006489,404684,873680,N/A,N/A,418466,178921246,397093,108910,1545231,92253
Admin,2021-09-01,US,932359,427249,378851364,206433738,398576,868940,N/A,N/A,406084,179327330,395046,121265,1666496,94915
Admin,2021-09-02,US,894657,404986,379746021,206838724,388255,855392,N/A,N/A,398966,179726296,390486,113770,1780266,95438
Admin,2021-09-03,US,1039995,455423,380786016,207294147,376825,836821,N/A,N/A,487730,180214026,383409,118811,1899077,94491
Admin,2021-09-04,US,559871,246697,381345887,207540844,366440,815221,N/A,N/A,276045,180490071,374414,44448,1943525,91733
Admin,2021-09-05,US,365857,168435,381711744,207709279,362814,806099,N/A,N/A,172434,180662505,369824,27531,1971056,90590
Admin,2021-09-06,US,177225,82894,381888969,207792173,314990,699362,N/A,N/A,86377,180748882,320871,11708,1982764,78063
Admin,2021-09-07,US,906912,355772,382795881,208147945,305922,696696,N/A,N/A,476716,181225598,329193,92089,2074853,75660
Admin,2021-09-08,US,842499,367000,383638380,208514945,297315,683859,N/A,N/A,398772,181624370,328148,95736,2170589,72013
Admin,2021-09-09,US,844820,373264,384483200,208888209,292784,676739,N/A,N/A,394691,182019061,327537,97196,2267785,69646
Admin,2021-09-10,US,1031447,450604,385514647,209338813,292095,675518,N/A,N/A,496819,182515880,328836,106502,2374287,67887
Admin,2021-09-11,US,595984,258963,386110631,209597776,293847,680677,N/A,N/A,298226,182814106,332005,48654,2422941,68488
Admin,2021-09-12,US,349414,157375,386460045,209755151,292267,678328,N/A,N/A,172363,182986469,331994,22918,2445859,67829
Admin,2021-09-13,US,779503,338921,387239548,210094072,328843,764368,N/A,N/A,381255,183367724,374120,75634,2521493,76961
Admin,2021-09-14,US,747608,316946,387987156,210411018,323296,741610,N/A,N/A,375675,183743399,359685,74134,2595627,74396
Admin,2021-09-15,US,758954,313467,388746110,210724485,315649,729675,N/A,N/A,386775,184130174,357972,77497,2673124,71791
Admin,2021-09-16,US,757662,311612,389503772,211036097,306841,717224,N/A,N/A,389747,184519921,357265,76994,2750118,68905
Admin,2021-09-17,US,899613,352178,390403385,211388275,292780,698391,N/A,N/A,478662,184998583,354671,89716,2839834,66507
Admin,2021-09-18,US,520349,205999,390923734,211594274,285214,687586,N/A,N/A,274097,185272680,351224,48402,2888236,66471
Admin,2021-09-19,US,303947,119600,391227681,211713874,279818,681090,N/A,N/A,163885,185436565,350013,23206,2911442,66512
Admin,2021-09-20,US,685586,266552,391913267,211980426,269479,667674,N/A,N/A,349229,185785794,345438,85594,2997036,67935
Admin,2021-09-21,US,672140,261492,392585407,212241918,261557,656893,N/A,N/A,340667,186126461,340437,88486,3085522,69985
Admin,2021-09-22,US,661580,254150,393246987,212496068,253083,642982,N/A,N/A,334214,186460675,332928,85271,3170793,71096
Admin,2021-09-23,US,671187,255409,393918174,212751477,245054,630628,N/A,N/A,327253,186787928,324001,102147,3272940,74689
Admin,2021-09-24,US,978501,321794,394896675,213073271,240714,641898,N/A,N/A,411790,187199718,314447,258176,3531116,98755
Admin,2021-09-25,US,668469,203997,395565144,213277268,240428,663058,N/A,N/A,228165,187427883,307886,241018,3772134,126271
Admin,2021-09-26,US,406844,120607,395971988,213397875,240572,677758,N/A,N/A,145000,187572883,305188,142915,3915049,143372
Admin,2021-09-27,US,1021400,300439,396993388,213698314,245413,725731,N/A,N/A,222428,187795311,287073,507991,4423040,203715
Admin,2021-09-28,US,1122862,292366,398116250,213990680,249823,790120,N/A,N/A,302575,188097886,281632,537600,4960640,267874
Admin,2021-09-29,US,1129284,290254,399245534,214280934,254981,856935,N/A,N/A,310262,188408148,278210,539363,5500003,332744
Admin,2021-09-30,US,1150393,290831,400395927,214571765,260041,925393,N/A,N/A,318510,188726658,276961,553020,6053023,397155
Admin,2021-10-01,US,1294779,316706,401690706,214888471,259314,970575,N/A,N/A,376648,189103306,271941,610421,6663444,447475
Admin,2021-10-02,US,625767,174697,402316473,215063168,255129,964475,N/A,N/A,206476,189309782,268842,249711,6913155,448717
Admin,2021-10-03,US,364105,106952,402680578,215170120,253178,958370,N/A,N/A,129938,189439720,266691,128789,7041944,446699
Admin,2021-10-04,US,974210,248728,403654788,215418848,245791,951628,N/A,N/A,255482,189695202,271413,479225,7521169,442590
Admin,2021-10-05,US,1006004,245664,404660792,215664512,239119,934934,N/A,N/A,255581,189950783,264699,514609,8035778,439305
Admin,2021-10-06,US,1020865,249486,405681657,215913998,233295,919446,N/A,N/A,257562,190208345,257171,523735,8559513,437073
Admin,2021-10-07,US,997528,250090,406679185,216164088,227475,897608,N/A,N/A,252587,190460932,247753,505907,9065420,430342
Admin,2021-10-08,US,1132832,284375,407812017,216448463,222856,874473,N/A,N/A,308717,190769649,238049,551325,9616745,421900
Admin,2021-10-09,US,532724,148350,408344741,216596813,219092,861181,N/A,N/A,167612,190937261,232497,221993,9838738,417940
Admin,2021-10-10,US,312213,93719,408656954,216690532,217202,853768,N/A,N/A,104367,191041628,228844,115405,9954143,416028
Admin,2021-10-11,US,848154,226715,409505108,216917247,214057,835760,N/A,N/A,220204,191261832,223804,410231,10364374,406172
Admin,2021-10-12,US,917348,229961,410422456,217147208,211814,823094,N/A,N/A,232602,191494434,220521,465044,10829418,399091
Admin,2021-10-13,US,895248,228210,411317704,217375418,208774,805149,N/A,N/A,227154,191721588,216177,451145,11280563,388721
Admin,2021-10-14,US,902605,227084,412220309,217602502,205488,791589,N/A,N/A,227324,191948912,212568,459603,11740166,382107
Admin,2021-10-15,US,1041187,262761,413261496,217865263,202400,778497,N/A,N/A,275734,192224646,207856,514765,12254931,376884
Admin,2021-10-16,US,488053,141338,413749549,218006601,201398,772115,N/A,N/A,143638,192368284,204431,208465,12463396,374951
Admin,2021-10-17,US,268140,84474,414017689,218091075,200078,765819,N/A,N/A,83868,192452152,201503,101310,12564706,372938
Admin,2021-10-18,US,824253,224541,414841942,218315616,199767,762404,N/A,N/A,210193,192662345,200073,399925,12964631,371465
Admin,2021-10-19,US,814479,203246,415656421,218518862,195951,747709,N/A,N/A,191612,192853957,194217,429596,13394227,366401
Admin,2021-10-20,US,827118,204377,416483539,218723239,192546,737976,N/A,N/A,193184,193047141,189364,440124,13834351,364827
Admin,2021-10-21,US,848537,208009,417332076,218931248,189821,730252,N/A,N/A,196010,193243151,184891,455112,14289463,364185
Admin,2021-10-22,US,1365379,294709,418697455,219225957,194385,776565,N/A,N/A,244255,193487406,180394,835900,15125363,410062
Admin,2021-10-23,US,823375,178574,419520830,219404531,199704,824468,N/A,N/A,132999,193620405,178874,515621,15640984,453941
Admin,2021-10-24,US,470394,109991,419991224,219514522,203350,853362,N/A,N/A,79937,193700342,178312,281488,15922472,479681
Admin,2021-10-25,US,1513099,305960,421504323,219820482,214981,951768,N/A,N/A,203408,193903750,177343,1010175,16932647,566859
Admin,2021-10-26,US,1545721,301097,423050044,220121579,228960,1056231,N/A,N/A,200068,194103818,178551,1053423,17986070,655978
Admin,2021-10-27,US,1606941,310406,424656985,220431985,244107,1167635,N/A,N/A,205814,194309632,180355,1099910,19085980,750233
Admin,2021-10-28,US,1593184,301085,426250169,220733070,257403,1274013,N/A,N/A,207371,194517003,181978,1095228,20181208,841678
Admin,2021-10-29,US,1769314,330368,428019483,221063438,262497,1331718,N/A,N/A,236642,194753645,180891,1213146,21394354,895570
Admin,2021-10-30,US,813927,169674,428833410,221233112,261226,1330368,N/A,N/A,118510,194872155,178821,532156,21926510,897932
Admin,2021-10-31,US,434240,101928,429267650,221335040,260074,1325203,N/A,N/A,70121,194942276,177419,264513,22191023,895507
Admin,2021-11-01,US,1442980,286629,430710630,221621669,257312,1315186,N/A,N/A,193977,195136253,176071,969190,23160213,889652
Admin,2021-11-02,US,1487326,286804,432197956,221908473,255271,1306844,N/A,N/A,187488,195323741,174274,1024816,24185029,885566
Admin,2021-11-03,US,1546975,313935,433744931,222222408,255775,1298278,N/A,N/A,190849,195514590,172136,1054747,25239776,879114
Admin,2021-11-04,US,1621004,353122,435365935,222575530,263209,1302252,N/A,N/A,191907,195706497,169927,1086757,26326533,877904
Admin,2021-11-05,US,1893634,456168,437259569,223031698,281180,1320012,N/A,N/A,227838,195934335,168670,1222726,27549259,879272
Admin,2021-11-06,US,1026523,390894,438286092,223422592,312783,1350383,N/A,N/A,116690,196051025,168410,525226,28074485,878282
Admin,2021-11-07,US,550769,228381,438836861,223650973,330848,1367030,N/A,N/A,69987,196121012,168390,256732,28331217,877171
Admin,2021-11-08,US,1448795,472397,440285656,224123370,357386,1367860,N/A,N/A,171929,196292941,165241,815451,29146668,855208
Admin,2021-11-09,US,1621730,524195,441907386,224647565,391299,1387061,N/A,N/A,165266,196458207,162066,940490,30087158,843161
Admin,2021-11-10,US,1749492,574025,443656878,225221590,428455,1415992,N/A,N/A,169186,196627393,158971,1013828,31100986,837316
Admin,2021-11-11,US,1586999,550234,445243877,225771824,456613,1411134,N/A,N/A,152849,196780242,153392,890770,31991756,809318
Admin,2021-11-12,US,1970908,639503,447214785,226411327,482804,1422173,N/A,N/A,198341,196978583,149178,1142573,33134329,797867
Admin,2021-11-13,US,1164353,533356,448379138,226944683,503156,1441863,N/A,N/A,102200,197080783,147108,531350,33665679,798742
Admin,2021-11-14,US,573970,240456,448953108,227185139,504881,1445178,N/A,N/A,60270,197141053,145720,275874,33941553,801477
Admin,2021-11-15,US,1534492,461923,450487600,227647062,503385,1457420,N/A,N/A,166050,197307103,144880,914660,34856213,815649
Admin,2021-11-16,US,1663972,489150,452151572,228136212,498378,1463455,N/A,N/A,166125,197473228,145003,1018210,35874423,826752
Admin,2021-11-17,US,1740648,507497,453892220,228643709,488874,1462191,N/A,N/A,171334,197644562,145309,1070726,36945149,834880
Admin,2021-11-18,US,1768635,507896,455660855,229151605,482826,1488139,N/A,N/A,170344,197814906,147809,1099273,38044422,864667
Admin,2021-11-19,US,2051558,583715,457712413,229735320,474856,1499661,N/A,N/A,193667,198008573,147141,1283107,39327529,884743
Admin,2021-11-20,US,1221410,459299,458933823,230194619,464277,1507812,N/A,N/A,100196,198108769,146855,665579,39993108,903918
Admin,2021-11-21,US,637034,206791,459570857,230401410,459467,1516821,N/A,N/A,59622,198168391,146762,372663,40365771,917745
Admin,2021-11-22,US,1792780,490555,461363637,230891965,463558,1553719,N/A,N/A,170204,198338595,147356,1139181,41504952,949820
Admin,2021-11-23,US,1770982,491732,463134619,231383697,463926,1569006,N/A,N/A,164656,198503251,147146,1122601,42627553,964733
Admin,2021-11-24,US,1368801,403474,464503420,231787171,449066,1515885,N/A,N/A,152622,198655873,144473,820996,43448549,929057
Admin,2021-11-25,US,27015,9006,464530435,231796177,377796,1267082,N/A,N/A,4986,198660859,120850,13013,43461562,773877
Admin,2021-11-26,US,1194124,313053,465724559,232109230,339130,1144592,N/A,N/A,174356,198835215,118091,710939,44172501,692139
Admin,2021-11-27,US,884500,221319,466609059,232330549,305133,1096462,N/A,N/A,196817,199032032,131894,469354,44641855,664107
Admin,2021-11-28,US,583791,143195,467192850,232473744,296048,1088856,N/A,N/A,145776,199177808,144202,296492,44938347,653225
Admin,2021-11-29,US,1643944,356195,468836794,232829939,276853,1067593,N/A,N/A,357789,199535597,171000,937987,45876334,624483
Admin,2021-11-30,US,1900372,407126,470737166,233237065,264767,1086078,N/A,N/A,387853,199923450,202885,1114220,46990554,623286
Admin,2021-12-01,US,2120556,459798,472857722,233696863,272813,1193471,N/A,N/A,405006,200328456,238940,1261544,48252098,686221
Admin,2021-12-02,US,2134411,448488,474992133,234145351,335596,1494528,N/A,N/A,390656,200719112,294036,1302858,49554956,870485
Admin,2021-12-03,US,2405867,487338,477398000,234632689,360494,1667634,N/A,N/A,485846,201204958,338534,1439374,50994330,974547
Admin,2021-12-04,US,1462535,301869,478860535,234934558,372001,1750210,N/A,N/A,446270,201651228,374170,716171,51710501,1009807
Admin,2021-12-05,US,720490,165810,479581025,235100368,375232,1769739,N/A,N/A,187620,201838848,380148,368303,52078804,1020065
Admin,2021-12-06,US,1805313,390606,481386338,235490974,380148,1792792,N/A,N/A,321609,202160457,374980,1096281,53175085,1042679
Admin,2021-12-07,US,1883527,403066,483269865,235894040,379568,1790385,N/A,N/A,337587,202498044,367799,1146887,54321972,1047345
Admin,2021-12-08,US,1898051,407919,485167916,236301959,372157,1758599,N/A,N/A,348425,202846469,359716,1146647,55468619,1030932
Admin,2021-12-09,US,1894829,404912,487062745,236706871,365931,1724373,N/A,N/A,334709,203181178,351723,1158869,56627488,1010362
Admin,2021-12-10,US,2074249,423866,489136994,237130737,356864,1676999,N/A,N/A,390685,203571863,338129,1263011,57890499,985167
Admin,2021-12-11,US,1240481,266759,490377475,237397496,351848,1645277,N/A,N/A,330724,203902587,321622,642998,58533497,974714
Admin,2021-12-12,US,622984,152098,491000459,237549594,349889,1631347,N/A,N/A,127826,204030413,313080,344626,58878123,971331
Admin,2021-12-13,US,1595082,347815,492595541,237897409,343776,1601314,N/A,N/A,274833,204305246,306398,976107,59854230,954164
Admin,2021-12-14,US,1690904,367283,494286445,238264692,338665,1573797,N/A,N/A,282470,204587716,298524,1046338,60900568,939799
Admin,2021-12-15,US,1690199,378462,495976644,238643154,334456,1544104,N/A,N/A,257099,204844815,285478,1059437,61960005,927341
Admin,2021-12-16,US,1662782,389648,497639426,239032802,332276,1510954,N/A,N/A,167806,205012621,261634,1111041,63071046,920508
Admin,2021-12-17,US,1903502,432639,499542928,239465441,333529,1486562,N/A,N/A,249176,205261797,241419,1222498,64293544,914721
Admin,2021-12-18,US,1107523,288110,500650451,239753551,336579,1467568,N/A,N/A,161005,205422802,217173,658313,64951857,916909
Admin,2021-12-19,US,633931,170151,501284382,239923702,339158,1469131,N/A,N/A,80992,205503794,210483,382599,65334456,922333
Admin,2021-12-20,US,1813169,441971,503097551,240365673,352609,1500287,N/A,N/A,223905,205727699,203207,1147349,66481805,946796
Admin,2021-12-21,US,1939938,466995,505037489,240832668,366854,1535863,N/A,N/A,239659,205967358,197091,1232379,67714184,973374
Admin,2021-12-22,US,1833068,447129,506870557,241279797,376663,1556273,N/A,N/A,236018,206203376,194080,1150724,68864908,986415
Admin,2021-12-23,US,1437775,368363,508308332,241648160,373623,1524129,N/A,N/A,175959,206379335,195244,894294,69759202,955451
Admin,2021-12-24,US,375322,103979,508683654,241752139,326671,1305818,N/A,N/A,55981,206435316,167645,216544,69975746,811743
Admin,2021-12-25,US,6153,2020,508689807,241754159,285801,1148479,N/A,N/A,882,206436198,144770,3218,69978964,718158
Admin,2021-12-26,US,473040,132265,509162847,241886424,280389,1125495,N/A,N/A,82104,206518302,144929,258423,70237387,700419
Admin,2021-12-27,US,1501864,394647,510664711,242281071,273628,1081022,N/A,N/A,226520,206744822,145303,881392,71118779,662425
Admin,2021-12-28,US,1660839,434133,512325550,242715204,268934,1041151,N/A,N/A,237763,206982585,145032,989778,72108557,627768
Admin,2021-12-29,US,1643798,435252,513969348,243150456,267237,1014113,N/A,N/A,233509,207216094,144674,975861,73084418,602787
Admin,2021-12-30,US,1501214,402317,515470562,243552773,272088,1023175,N/A,N/A,211486,207427580,149749,888836,73973254,602007
Admin,2021-12-31,US,597836,161710,516068398,243714483,280335,1054963,N/A,N/A,91988,207519568,154893,344782,74318036,620327
Admin,2022-01-01,US,98789,33129,516167187,243747612,284779,1068197,N/A,N/A,15554,207535122,156989,49769,74367805,626977
Admin,2022-01-02,US,489889,137343,516657076,243884955,285504,1070604,N/A,N/A,89272,207624394,158013,263593,74631398,627716
Admin,2022-01-03,US,1216032,342140,517873108,244227095,278003,1029771,N/A,N/A,193605,207817999,153311,682688,75314086,599330
Admin,2022-01-04,US,1385473,373611,519258581,244600706,269357,990433,N/A,N/A,211309,208029308,149531,803139,76117225,572667
Admin,2022-01-05,US,1414350,380297,520672931,244981003,261507,957654,N/A,N/A,209310,208238618,146074,827775,76945000,551512
Admin,2022-01-06,US,1426309,370880,522099240,245351883,257016,946954,N/A,N/A,209016,208447634,145722,848636,77793636,545769
Admin,2022-01-07,US,1600830,399866,523700070,245751749,291038,1090238,N/A,N/A,240509,208688143,166939,961919,78755555,633931
Admin,2022-01-08,US,1024818,274754,524724888,246026503,325556,1222528,N/A,N/A,171633,208859776,189236,578956,79334511,709529
Admin,2022-01-09,US,487154,142350,525212042,246168853,326271,1222138,N/A,N/A,73468,208933244,186978,271725,79606236,710691
Admin,2022-01-10,US,1228888,330994,526440930,246499847,324679,1223974,N/A,N/A,187139,209120383,186054,713410,80319646,715080
Admin,2022-01-11,US,1276069,339189,527716999,246839036,319761,1208345,N/A,N/A,198185,209318568,184180,740743,81060389,706166
Admin,2022-01-12,US,1275756,340147,528992755,247179183,314026,1188546,N/A,N/A,196540,209515108,182355,741499,81801888,693841
Admin,2022-01-13,US,1254534,335807,530247289,247514990,309015,1164007,N/A,N/A,184926,209700034,178914,734759,82536647,677573
Admin,2022-01-14,US,1431283,378826,531678572,247893816,306010,1139786,N/A,N/A,171588,209871622,169068,880297,83416944,665913
Admin,2022-01-15,US,769961,225139,532448533,248118955,298922,1103377,N/A,N/A,85673,209957295,156788,458281,83875225,648673
Admin,2022-01-16,US,382641,106180,532831174,248225135,293755,1088447,N/A,N/A,56868,210014163,154417,219214,84094439,641172
Admin,2022-01-17,US,807745,215980,533638919,248441115,277324,1028284,N/A,N/A,137813,210151976,147370,452782,84547221,603939
Admin,2022-01-18,US,969815,253377,534608734,248694492,265065,984533,N/A,N/A,184206,210336182,145373,530839,85078060,573953
Admin,2022-01-19,US,949799,253107,535558533,248947599,252631,937968,N/A,N/A,182218,210518400,143327,512983,85591043,541308
Admin,2022-01-20,US,904950,241200,536463483,249188799,239116,888027,N/A,N/A,172202,210690602,141509,489871,86080914,506324
Admin,2022-01-21,US,1044906,279807,537508389,249468606,224970,832831,N/A,N/A,157081,210847683,139437,605640,86686554,467087
Admin,2022-01-22,US,602708,174490,538111097,249643096,217734,808937,N/A,N/A,80678,210928361,138723,345682,87032236,451002
Admin,2022-01-23,US,323499,92061,538434596,249735157,215717,800488,N/A,N/A,62713,210991074,139558,168107,87200343,443701
Admin,2022-01-24,US,771512,204855,539206108,249940012,214128,795312,N/A,N/A,156477,211147551,142225,408088,87608431,437316
Admin,2022-01-25,US,777085,204357,539983193,250144369,207125,767779,N/A,N/A,171309,211318860,140382,399197,88007628,418510
Admin,2022-01-26,US,765703,201374,540748896,250345743,199735,741480,N/A,N/A,174605,211493465,139295,387563,88395191,400593
Admin,2022-01-27,US,762021,198084,541510917,250543827,193575,721062,N/A,N/A,170477,211663942,139048,390231,88785422,386358
Admin,2022-01-28,US,923750,230188,542434667,250774015,186487,703754,N/A,N/A,203906,211867848,145737,484606,89270028,369068
Admin,2022-01-29,US,457375,122042,542892042,250896057,178994,682992,N/A,N/A,108874,211976722,149765,223834,89493862,351661
Admin,2022-01-30,US,257320,72021,543149362,250968078,176132,673538,N/A,N/A,65289,212042011,150133,118937,89612799,344637
Admin,2022-01-31,US,609733,160737,543759095,251128815,169829,650426,N/A,N/A,153792,212195803,149750,292326,89905125,328099
Admin,2022-02-01,US,583929,147741,544343024,251276556,161741,622833,N/A,N/A,154321,212350124,147323,278266,90183391,310823
Admin,2022-02-02,US,545049,140198,544888073,251416754,153002,591311,N/A,N/A,149202,212499326,143694,251641,90435032,291406
Admin,2022-02-03,US,497766,127873,545385839,251544627,142971,553560,N/A,N/A,135331,212634657,138673,231620,90666652,268747
Admin,2022-02-04,US,630464,152670,546016303,251697297,131897,511662,N/A,N/A,178432,212813089,135034,295279,90961931,241700
Admin,2022-02-05,US,422626,108379,546438929,251805676,129946,506698,N/A,N/A,128266,212941355,137804,183048,91144979,235874
Admin,2022-02-06,US,205703,58964,546644632,251864640,128080,499324,N/A,N/A,58299,212999654,136806,87046,91232025,231318
Admin,2022-02-07,US,463337,126044,547107969,251990684,123124,478410,N/A,N/A,127310,213126964,133023,205550,91437575,218921
Admin,2022-02-08,US,480809,123549,547588778,252114233,119668,463679,N/A,N/A,140656,213267620,131070,211967,91649542,209450
Admin,2022-02-09,US,489063,127690,548077841,252241923,117881,455681,N/A,N/A,139993,213407613,129755,217069,91866611,204511
Admin,2022-02-10,US,484964,125680,548562805,252367603,117568,453852,N/A,N/A,134610,213542223,129652,219970,92086581,202847
Admin,2022-02-11,US,595852,148409,549158657,252516012,116959,448907,N/A,N/A,167334,213709557,128066,274219,92360800,199838
Admin,2022-02-12,US,333914,90164,549492571,252606176,114357,436234,N/A,N/A,98697,213808254,123842,141767,92502567,193941
Admin,2022-02-13,US,146615,41792,549639186,252647968,111904,427793,N/A,N/A,44314,213852568,121844,58714,92561281,189894
Admin,2022-02-14,US,326039,86494,549965225,252734462,106254,408179,N/A,N/A,93254,213945822,116979,141915,92703196,180803
Admin,2022-02-15,US,382719,97922,550347944,252832384,102593,394166,N/A,N/A,110621,214056443,112689,168960,92872156,174659
Admin,2022-02-16,US,393010,99936,550740954,252932320,98628,380444,N/A,N/A,111674,214168117,108643,176291,93048447,168834
Admin,2022-02-17,US,385778,96106,551126732,253028426,94403,366275,N/A,N/A,104466,214272583,104337,178859,93227306,162961
Admin,2022-02-18,US,498607,121478,551625339,253149904,90556,352383,N/A,N/A,135580,214408163,99800,233490,93460796,157142
Admin,2022-02-19,US,268744,73658,551894083,253223562,88198,343073,N/A,N/A,74242,214482405,96307,117211,93578007,153634
Admin,2022-02-20,US,146904,41818,552040987,253265380,88202,343114,N/A,N/A,40087,214522492,95703,62844,93640851,154224
Admin,2022-02-21,US,304518,80062,552345505,253345442,87283,340040,N/A,N/A,84439,214606931,94444,134099,93774950,153108
Admin,2022-02-22,US,325784,85309,552671289,253430751,85481,331906,N/A,N/A,90289,214697220,91539,143904,93918854,149528
Admin,2022-02-23,US,318134,83655,552989423,253514406,83155,321209,N/A,N/A,85215,214782435,87759,143215,94062069,144803
Admin,2022-02-24,US,303829,78583,553293252,253592989,80652,309502,N/A,N/A,78926,214861361,84111,139897,94201966,139237
Admin,2022-02-25,US,364115,91915,553657367,253684904,76429,290289,N/A,N/A,96196,214957557,78484,168590,94370556,129966
Admin,2022-02-26,US,227069,63397,553884436,253748301,74963,284336,N/A,N/A,58767,215016324,76274,101522,94472078,127724
Admin,2022-02-27,US,116436,33777,554000872,253782078,73814,279983,N/A,N/A,29424,215045748,74750,51546,94523624,126110
Admin,2022-02-28,US,289221,74230,554290093,253856308,72981,277798,N/A,N/A,73278,215119026,73156,136094,94659718,126395
Admin,2022-03-01,US,245735,64555,554535828,253920863,70016,266362,N/A,N/A,64214,215183240,69431,110685,94770403,121650
Admin,2022-03-02,US,222798,59539,554758626,253980402,66571,252743,N/A,N/A,61748,215244988,66079,96441,94866844,114968
Admin,2022-03-03,US,194984,50929,554953610,254031331,62620,237194,N/A,N/A,52755,215297743,62340,86845,94953689,107389
Admin,2022-03-04,US,147532,36483,555101142,254067814,54701,206253,N/A,N/A,40881,215338624,54438,66114,95019803,92750
Admin,2022-03-05,US,11211,3231,555112353,254071045,46106,175416,N/A,N/A,3447,215342071,46535,4336,95024139,78866
Admin,2022-03-06,US,0,0,555112353,254071045,41281,158783,N/A,N/A,0,215342071,42331,0,95024139,71502
